0                                                0
0                                                0
0                                                0
0                                                0
0               K                               K0
0     b    b    b                               b0
0                                                0
0                                             b  0
0 b                                              0
0                                                0
0                 b    b    b    b    b    b     0
0    b                                           0
0                   B          K                 0
0              b    b          b                 0
0 b                 b                           K0
0                   b                      bbbbbb0
0            b      bBB    b                    b0
0    b              b        K                  b0
0       b           b        b             BBBBBb0
0                   b                           b0
0 b                 bBB                         b0
0                   b                      BBBBBb0
0                   D                            0
0   b               d                            0
BBBBBBBBBBBBBBBBBBBBBBBBBBBBBBBBBBBBBBBBBBBBBBBBBB
bQbQQbqqbbQQbqqbQQbbqqbQQbqqbbQQbqqbQQbbqqbQQbqqbb
b b  b  bb  b  b  bb  b  b  bb  b  b  bb  b  b  bb
bbbbbbbbbbbbbbbbbbbbbbbbbbbbbbbbbbbbbbbbbbbbbbbbbb
bqbQQbQQbbqqbQQbqqbbQQbqqbQQbbqqbQQbqqbbQQbqqbQQbb
b b  b  bb  b  b  bb  b  b  bb  b  b  bb  b  b  bb